f	i_st	i_en	p_sz	c_n	len	pat
Brushtail_foc	26760	27155	24	16.5	395	CCCCCTCCCTCCTCTCTTCCTCCT
Brushtail_foc	26805	27270	17	24.3	465	CCTCCCCTCCCTCCTCTCC
Brushtail_foc	26836	27261	24	19.9	425	CCTCTCCCTCCTCTCCTCTTC
Brushtail_foc	26893	27262	3	121.7	369	CCT
Brushtail_foc	26762	27136	66	5.6	374	CCCTCCTCTCCTCTCCTCCTCCTCCCCCTCCCTCCTCTCCTTTTCCTCCCCTCCCTTCACTCCCCG
Brushtail_foc	26760	27270	45	11.7	510	CCCCCTCCCTCCTCTCCTCCTCCCCCTCCCTCCTCTCCTCCT
Brushtail_foc	27241	27296	19	3.0	55	CTCCCCCTCCCTCTTCCCA
Echidna_foc	22685	23090	219	1.9	405	TTGTACATATCTATTCTATTCATTTTATTTTGTTAGTACGTTTGGTTTTGTTCTCTGTCTCCCCCTTCTAGACTGTGAGCCCACTGTTGGGTAGGGACCGTCTCTATATGGTGCCAACTTGGACTTCCCAAGCGCTCAGTACAGTGCTCTGCACACAGTAAGCGCTCAATAAATACAACTGAATGAACGTATAACATTTACTCGGTTTATTTATTTTAC
Echidna_foc	23257	23361	23	4.5	104	TTTATTTATTTTACTTGTACATG
Echidna_foc	23255	23370	32	3.4	115	TATTTATTTATTTTACTTGTACATGTTTATTC
Echidna_foc	23175	23386	70	3.0	211	TTACTCGATGTATTTATTTATTTTACTTGTACATGTTTATTCTATTTATTTTATTTGGTTTAATATGTTG
Echidna_foc	23224	23337	32	3.2	113	TTTATTTGGTTTAATATGTTGTTACTCGATGTATTTA
Echidna_foc	23581	24020	91	4.8	439	GGGGGGGCGCGGTTTCAGGTTCCCCCCTCGGCCTCGCTCCGCCCGGGCGCCCCACGCTCAGGGCTGCGCGCGCACGAGTGGCCCAAGGGCACGGG
Echidna_foc	23680	24007	185	1.8	327	GCGGTTTCAGGCTCCCCCCTCGACCTCGCTCCCGCCCGGCCGACCCACGCTCAGGGCTGCGCGCGCACGAGTGACCCGAGGGGACGGGGGAACGGTTTCAGGCTCCCCCCTCGGCCTCGCTCCCGCCCGGGCGCCGCACGCTCTGGGCTACGCACGCGCGCACGAAAGGACGTGGAGA
Echidna_foc	23923	24278	182	2.0	355	GCGCGCGCACGAGCGACCCGAGGGGACGGGGGAACGGTTTCAGGCTCCCCCCTCGACCTCGCTCCCGCCCGGGCGCCTCACGATCGGGGCTGCGCGCGCGCGCACGAGCGGCCCGAGAGGACGTGGGGAGCGTTTTCAGGCCCCCCCCCCCCTCGACCTCAATCCCGCCCGGGCGCCGC
Echidna_foc	24104	24292	100	1.9	188	GCGCGCGCACGAGCGGCCCGAGAGGCCGGGGGCAGCGTTTTCAGGCCCCCCCCCTCGACCTCGCTCCCGCCCGGGCCCCTCACGATCGGGGCTGCGT
Echidna_foc	24105	24317	96	2.2	212	CGCGCGCACGAGCGGCCCGAGAGGCCGGGGGCAGCGTTTTCAGGCCCCCCCCTCGACCTCGCTCCCGCCCGGGCCCCTCACGATCGGGGCACGTA
Echidna_foc	24460	24496	2	18.5	36	CA
Echidna_foc	24453	24497	12	3.5	44	CACACCACACACA
Echidna_foc	24793	24825	10	3.3	32	CCCGGCCCGG
Echidna_foc	24793	24825	15	2.2	32	CCCGCCCCGGCCCGG
Echidna_foc	24945	24979	18	1.9	34	CCCTCCGCCGCCCGCCCG
Echidna_foc	24956	24984	14	2.1	28	CCGCCCGCCCTCCG
Echidna_foc	25216	25294	14	5.7	78	CTCCCCCCCTCCC
Echidna_foc	25211	25293	26	2.9	82	CGCCCTCCCCCCCTTCCCCTCCCCCCGT
Echidna_foc	25387	25829	34	13.2	442	TCCCCTCCCTCTCCTCCCCTTCCTTCCTCTCCCC
Echidna_foc	25438	25720	29	9.6	282	TCCCCTTCCTTCCTCTCCCCTCCCTCTCC
Echidna_foc	25413	25711	115	2.7	298	CCTCTCCCCTCCCTCTTCCCCTTCCCTCTTCCCTCCCCTCCCCTCCCTCTCCTCCCCTTCCTTCCTCTCCCTTCCCCTCTCTCGCCCCCTCCCTCCTCTCTTTTCCCATTCCCT
Echidna_foc	25516	25834	20	14.3	318	TTCCCCTCCTCCTCTCCCTCCC
Echidna_foc	25531	25624	29	3.3	93	CTCCCTCCCCTTCCCCTCCTCCTCTCCCC
Echidna_foc	25646	25720	14	5.2	74	CTCCCCCTCTTCCT
Echidna_foc	25560	25706	78	1.9	146	TCCCTCCCCTCCCCCTCCTCTCTCCTCCCTCCTCCCCTTCCCCTCCTCCTCGCCCCCTCCCTCCTCTCTTTTCCCAT
Echidna_foc	25449	25689	5	47.6	240	CTCCC
Echidna_foc	25661	25781	66	1.9	120	TCCCCTTCCTCCTCCCCTTCCCCTCCTCCTCTGCCCCTTCTCCTCTCCCCTTTCCTCTCTTT
Echidna_foc	25643	25790	29	4.9	147	CTCCTCTCCCCTCCTCCTCTCCCCTTTC
Echidna_foc	25905	25939	4	8.8	34	GTCG
Elephant_foc	25013	25052	15	2.7	39	CCGCCGCCGCCACCA
Elephant_foc	25015	25059	18	2.5	44	GCCGCCACCACCACCGCT
Human_foc	25007	25061	3	18.3	54	CCG
Koala_foc	24192	24216	6	4.2	24	TCGGGC
Koala_foc	26856	27274	8	48.1	418	CTCCTCTCC
Koala_foc	26856	27270	24	17.7	414	CTCCTCATCCCTCCTCCCTTCTTC
Koala_foc	26868	26986	45	2.6	118	CCTCCCTTCTTCCTCCTCCCTCTCCTCTCTCTCTTCCCCCTCCCGC
Koala_foc	26912	26965	18	2.9	53	CCCTCCCTCCTCTCCTCC
Koala_foc	26975	27016	12	3.3	41	TCCCTCTCCTCT
Koala_foc	27019	27124	22	5.3	105	CCCTCTTCTCCTCATCCC
Koala_foc	27045	27258	25	9.2	213	CTCCTCATCCCCCCTCCCTCCTCTC
Koala_foc	27150	27270	3	41.3	120	CCT
Koala_foc	27099	27258	48	3.3	159	TCCCTCCTCTCCTCCTCATCCCCCTCCCTCCTCTCCTCCTCATCCCCCC
Koala_foc	27099	27258	73	2.2	159	TCCCTCCTCTCCTCCTCATCCCCCCTCCCTCCTCTCCTCCTCATCCCCCTCCCTCCTCTCCTCCTCATCCCCC
Koala_foc	26891	27273	42	8.8	382	TCCTCTCCTCCTCATCCCCCTCCCTCCTCTCCTCCCCCTCCC
Koala_foc	27056	27274	73	3.2	218	CCCTCCTCTCCCTGCTCCTCATCCCCCTCCCTCCTCTCCTCCTCATCCCCCTCCCTCCTCTCCTCCCCCT
Mouse_foc	24182	24206	1	25.0	24	A
Mouse_foc	25031	25081	3	16.7	50	CCG
Mouse_foc	25031	25081	9	5.6	50	CCGCCGCCA
Opossum_foc	24785	24819	17	2.1	34	TTGGGGAAAGGGTCTGC
Opossum_foc	25431	25514	29	3.0	83	GTCTCTCCTAAGTCCTTTAAGTCCAGTCC
Opossum_foc	26846	27253	24	17.4	407	TCCCTCCTCTCTCCTCTTCCCCC
Opossum_foc	26852	27262	71	5.9	410	CTCTCCCTCTTCCCCCTCCTTCCACTCTCCCTCTTCCCCTCCCTTCTCTCTCCCCCCTCCCCCTCCCTCCT
Platypus_foc	25427	25682	94	2.6	255	GCCTCGAATGGGCTTCCCGGACTCTCCCCCCAACCCCCACCCTCCCCTCCTCCTCCGACCCTCCCCGTCCTCCCTAGCCCTCCTCCTCTCCTCCTCCA
Platypus_foc	25580	25623	21	2.1	43	CCTCCCCGTCCTCTCCTGCCT
Platypus_foc	25724	26065	64	5.1	341	TCCTCCTCTCCAGCCCTCCGACCTCGGATGGGCTTCCCAGACTCTCCCACCAACCCCAACCCCA
Platypus_foc	25716	26224	70	7.2	508	CCTCCTCCTCCTCCTCTCCAGCCCTCCGACCTCGGATGGGCTTCCCAGACTCTCCCACCAACCCCAACC
Platypus_foc	25924	26230	146	2.1	306	TCCTCCTCATCCTCCCCTCCAGCCCTCCAGCCTCGATTGGGCTTCCCAGACCCTCCCACCAACCCCAACCTCATCCTCTCCTCTCCAGCCCTCCGGCCTCGGATGGGCTTCCCAGACTCTTCCCACCAACCCCAACCTCCTCCCCA
Platypus_foc	26071	26221	67	2.2	150	CCTCCTCCTCCTCCTCTCCAGCCCTCCAGCCTTCGATGGGCTTCCCAGACTCCTCCCACCAACCCCAA
Platypus_foc	26208	26242	9	3.9	34	TCCTCCTCA
Tammar_foc	26067	26103	12	3.1	36	GAGTGTGTGCGC
Tammar_foc	26103	26129	14	1.9	26	GCTTGTGCAAGCGT
Tammar_foc	26801	26836	18	2.0	35	GCACCCCCCCCCCCCGCC
Tammar_foc	26805	26847	18	2.4	42	CCCCCTCCCCCGCCCCA
Tammar_foc	26843	27186	24	13.0	343	CCCTCTCCTCTTCTTTCTCCTCCTCCT
Tammar_foc	26934	27292	24	15.0	358	TCCCCTCCCTCCTCTTCTCCTCCT
Tammar_foc	26916	27298	3	129.7	382	CCT
Tammar_foc	26946	27228	152	1.9	282	CTCTCCTCCTCCTACCCCTCCCTCCTCTTCTCCTCCTACCCCTCCCTCCTCTTCTCCTCCTACTCCTCCCTCTTCTCCTCCTCCCCTCCCTTCTCTCCTCCCTCCCTCCTCTCACCCCTCCCTTCTCTCCTCCTCCTACCCCTCCCCTT
Tammar_foc	26917	27304	128	3.0	387	CTCCTCCTCCCTCATCCTCCCACTCCCTCCTCTCCTCCTCCTACCCCTCCCTCCTCTCCTCCTCCTACCCCTCCCTCCTCTTCTCCTCCTACCCCTCCCTCCTCTTCTCCTCCTACCCCTCCCTCTT
Tammar_foc	27010	27301	43	6.7	291	CCTCCCTCCTCTCCTCCCCCCTCCCTCCTCTCTTCTCTCCC
